1111111
10C0CE1
10P0CE1
10010X1
1111111