11111111111111111111111
100000000100000010C1001
1E1X0100101000010000001
1C0000000000000000X0001
101000P0000100C00000001
10000000010000001001001
10000000010000001000011
11111111111111111111111