111111111111111111111
1E1001001010X00100001
1C0000000X00000010011
10100X000001000000101
1P00000001000X0010011
111111111111111111111