1111111111111111111111111
100000000100000010C100001
1E1X01001010000100C000001
1C0000000000000000X000001
101000P0000100C0000000001
1000C00001000000100100001
10000000010000001000010C1
1C0000000000000000X000001
1111111111111111111111111