1111111
10C0C01
10P0CE1
10010X1
1111110