1111111
10P0CA1
1E010X1
1111111